County,ReportingDate,confirmed_cases,deaths,CFR,outbreaks,Closed_Outbreaks,Open_Outbreaks,facilities
Cook,2021-01-01,21427,3011,0.14052363840014934,519,261,258,389
DuPage,2021-01-01,4652,583,0.12532244196044712,149,71,78,100
Lake,2021-01-01,3594,464,0.12910406232609906,121,60,61,96
Will,2021-01-01,2832,297,0.1048728813559322,76,44,32,46
Kane,2021-01-01,2604,292,0.11213517665130568,92,57,35,67
Madison,2021-01-01,1915,233,0.1216710182767624,59,27,32,44
St. Clair,2021-01-01,1662,171,0.10288808664259928,52,13,39,49
Winnebago,2021-01-01,1635,185,0.11314984709480122,54,27,27,47
Sangamon,2021-01-01,1166,110,0.09433962264150944,30,17,13,27
Rock Island,2021-01-01,1155,151,0.13073593073593073,28,11,17,22
Kankakee,2021-01-01,1141,69,0.060473269062226116,23,11,12,18
Peoria,2021-01-01,1105,111,0.10045248868778281,30,15,15,26
McHenry,2021-01-01,950,131,0.13789473684210526,34,18,16,28
LaSalle,2021-01-01,937,157,0.16755602988260407,20,9,11,15
Tazewell,2021-01-01,892,106,0.11883408071748879,34,14,20,31
Clinton,2021-01-01,657,53,0.0806697108066971,17,8,9,15
McLean,2021-01-01,626,66,0.10543130990415335,21,8,13,18
Adams,2021-01-01,598,47,0.07859531772575251,13,4,9,12
Macon,2021-01-01,572,63,0.11013986013986014,15,6,9,11
Marion,2021-01-01,569,51,0.08963093145869948,11,1,10,10
Knox,2021-01-01,548,87,0.15875912408759124,14,1,13,13
Coles,2021-01-01,546,60,0.10989010989010989,19,8,11,18
Whiteside,2021-01-01,534,83,0.15543071161048688,14,3,11,14
DeKalb,2021-01-01,523,42,0.08030592734225621,15,7,8,14
Champaign,2021-01-01,479,42,0.08768267223382047,30,19,11,24
Williamson,2021-01-01,389,55,0.14138817480719795,14,4,10,13
Morgan,2021-01-01,366,55,0.15027322404371585,10,5,5,9
Jefferson,2021-01-01,338,49,0.14497041420118342,9,4,5,8
Monroe,2021-01-01,328,42,0.12804878048780488,7,2,5,7
Bureau,2021-01-01,309,35,0.11326860841423948,7,1,6,7
Boone,2021-01-01,307,44,0.14332247557003258,7,3,4,7
Ford,2021-01-01,293,33,0.11262798634812286,10,6,4,8
Randolph,2021-01-01,292,20,0.0684931506849315,12,5,7,9
Vermilion,2021-01-01,280,33,0.11785714285714285,12,1,11,10
Iroquois,2021-01-01,275,28,0.10181818181818182,9,3,6,9
Macoupin,2021-01-01,270,51,0.18888888888888888,17,6,11,13
Lee,2021-01-01,269,37,0.137546468401487,6,2,4,5
Woodford,2021-01-01,237,28,0.11814345991561181,8,1,7,7
Jackson,2021-01-01,236,31,0.13135593220338984,9,2,7,7
Franklin,2021-01-01,235,24,0.10212765957446808,7,1,6,7
Ogle,2021-01-01,233,32,0.13733905579399142,9,3,6,9
Pike,2021-01-01,229,22,0.09606986899563319,4,1,3,4
Richland,2021-01-01,223,26,0.11659192825112108,7,1,6,7
Perry,2021-01-01,208,35,0.16826923076923078,6,2,4,6
Livingston,2021-01-01,199,33,0.1658291457286432,11,1,10,10
Kendall,2021-01-01,194,32,0.16494845360824742,8,5,3,8
Christian,2021-01-01,192,38,0.19791666666666666,10,3,7,10
Jersey,2021-01-01,186,26,0.13978494623655913,6,1,5,6
McDonough,2021-01-01,180,38,0.2111111111111111,10,5,5,10
Stephenson,2021-01-01,178,30,0.16853932584269662,7,1,6,6
Logan,2021-01-01,175,37,0.21142857142857144,7,2,5,5
Mason,2021-01-01,170,26,0.15294117647058825,6,3,3,6
Moultrie,2021-01-01,168,17,0.10119047619047619,7,1,6,7
Henry,2021-01-01,163,29,0.17791411042944785,7,0,7,7
Shelby,2021-01-01,162,14,0.08641975308641975,5,3,2,4
Lawrence,2021-01-01,160,17,0.10625,2,0,2,2
Carroll,2021-01-01,150,17,0.11333333333333333,3,0,3,3
Fayette,2021-01-01,145,18,0.12413793103448276,5,1,4,5
Effingham,2021-01-01,145,24,0.16551724137931034,5,1,4,5
Grundy,2021-01-01,144,8,0.05555555555555555,4,1,3,4
Union,2021-01-01,140,20,0.14285714285714285,5,3,2,5
Clark,2021-01-01,129,20,0.15503875968992248,5,1,4,5
Greene,2021-01-01,125,25,0.2,1,0,1,1
Clay,2021-01-01,122,20,0.16393442622950818,3,1,2,3
Cass,2021-01-01,119,21,0.17647058823529413,3,2,1,3
Wayne,2021-01-01,115,19,0.16521739130434782,5,2,3,5
White,2021-01-01,111,12,0.10810810810810811,2,0,2,2
Fulton,2021-01-01,109,6,0.05504587155963303,4,0,4,4
Massac,2021-01-01,103,20,0.1941747572815534,1,0,1,1
Jo Daviess,2021-01-01,100,12,0.12,4,2,2,3
Wabash,2021-01-01,99,3,0.030303030303030304,2,1,1,2
Bond,2021-01-01,95,8,0.08421052631578947,4,2,2,4
De Witt,2021-01-01,92,17,0.18478260869565216,1,0,1,1
Edgar,2021-01-01,91,19,0.2087912087912088,4,1,3,4
Saline,2021-01-01,86,22,0.2558139534883721,2,0,2,2
Jasper,2021-01-01,74,10,0.13513513513513514,3,2,1,2
Warren,2021-01-01,70,15,0.21428571428571427,5,2,3,3
Washington,2021-01-01,64,16,0.25,3,1,2,3
Mercer,2021-01-01,63,12,0.19047619047619047,2,1,1,2
Cumberland,2021-01-01,62,14,0.22580645161290322,3,1,2,2
Crawford,2021-01-01,61,12,0.19672131147540983,2,0,2,2
Montgomery,2021-01-01,60,4,0.06666666666666667,7,2,5,7
Stark,2021-01-01,58,10,0.1724137931034483,1,0,1,1
Brown,2021-01-01,52,9,0.17307692307692307,1,0,1,1
Schuyler,2021-01-01,42,10,0.23809523809523808,1,0,1,1
Douglas,2021-01-01,37,5,0.13513513513513514,5,1,4,4
Hancock,2021-01-01,36,10,0.2777777777777778,2,0,2,2
Menard,2021-01-01,28,6,0.21428571428571427,1,0,1,1
Piatt,2021-01-01,17,5,0.29411764705882354,2,0,2,2
Henderson,2021-01-01,16,2,0.125,1,0,1,1
Marshall,2021-01-01,11,0,0.0,1,0,1,1
Scott,2021-01-01,9,0,0.0,2,1,1,2
Johnson,2021-01-01,7,4,0.5714285714285714,1,0,1,1
Calhoun,2021-01-01,2,0,0.0,1,1,0,1
